"helix - sp"	"A privilege from CAMI"
"ulx votekickminvotes"	""
"helix - viewdata"	"A privilege from CAMI"
"helix - allowflagup"	"A privilege from CAMI"
"helix - manage panels"	"A privilege from CAMI"
"screencap"	"A privilege from CAMI"
"helix - shove"	"A privilege from CAMI"
"helix - discord"	"A privilege from CAMI"
"helix - plytransfer"	"A privilege from CAMI"
"ulx rslots"	" - Sets the number of reserved slots, only applicable for modes 1 and 2."
"helix - scanner"	"A privilege from CAMI"
"bypass prop-protection"	"A privilege from CAMI"
"helix - event"	"A privilege from CAMI"
"ulx vote"	"Grants access to the ulx vote command"
"helix - exitact"	"A privilege from CAMI"
"manage reports"	"A privilege from CAMI"
"helix - plynotarget"	"A privilege from CAMI"
"ulx logchat"	"Log player chat"
"map"	"A privilege from CAMI"
"get friends"	"A privilege from CAMI"
"helix - bypass ratio enforcer"	"A privilege from CAMI"
"respond to help requests"	"A privilege from CAMI"
"npc target"	"A privilege from CAMI"
"extinguish"	"A privilege from CAMI"
"helix - itemspawnadd"	"A privilege from CAMI"
"bring"	"A privilege from CAMI"
"ulx asay"	"Grants access to the ulx asay command"
"helix - plyban"	"A privilege from CAMI"
"helix - plysend"	"A privilege from CAMI"
"ulx votemap2successratio"	""
"ulx votemapwaittime"	""
"ulx hp"	"Grants access to the ulx hp command"
"ulx kickafternamechangeswarning"	"<1/0> - Display a warning to users to let them know how many more times they can change their name."
"give weapon"	"A privilege from CAMI"
"ulx unignite"	"Grants access to the ulx unignite command"
"helix - setcallsign"	"A privilege from CAMI"
"helix - charsettokens"	"A privilege from CAMI"
"ulx ban"	"Grants access to the ulx ban command"
"ulx votemapmintime"	""
"ulx slap"	"Grants access to the ulx slap command"
"helix - charkick"	"A privilege from CAMI"
"ulx ignite"	"Grants access to the ulx ignite command"
"helix - chartie"	"A privilege from CAMI"
"helix - viewobjectives"	"A privilege from CAMI"
"helix - swap"	"A privilege from CAMI"
"ulx playsound"	"Grants access to the ulx playsound command"
"helix - radio"	"A privilege from CAMI"
"helix - textremove"	"A privilege from CAMI"
"helix - dispatch"	"A privilege from CAMI"
"ulx ungimp"	"Grants access to the ulx ungimp command"
"helix - setlistenfreq"	"A privilege from CAMI"
"ulx votemapminvotes"	""
"ulx ragdoll"	"Grants access to the ulx ragdoll command"
"helix - becomeclass"	"A privilege from CAMI"
"helix - setchannel"	"A privilege from CAMI"
"helix - doorremoveowner"	"A privilege from CAMI"
"helix - waypointupdate"	"A privilege from CAMI"
"ulx freeze"	"Grants access to the ulx freeze command"
"ulx spectate"	"Grants access to the ulx spectate command"
"helix - charsetmodelsec"	"A privilege from CAMI"
"helix - respawnbring"	"A privilege from CAMI"
"ulx gag"	"Grants access to the ulx gag command"
"helix - broadcast"	"A privilege from CAMI"
"ulx votekicksuccessratio"	""
"give ammo"	"A privilege from CAMI"
"helix - charsetdivision"	"A privilege from CAMI"
"ulx votekick"	"Grants access to the ulx votekick command"
"set credits"	"A privilege from CAMI"
"ulx userdeny"	"Grants access to the ulx userdeny command"
"helix - respawnstay"	"A privilege from CAMI"
"helix - npcspawndisplay"	"A privilege from CAMI"
"goto"	"A privilege from CAMI"
"ulx votemapenabled"	""
"ulx cexec"	"Grants access to the ulx cexec command"
"ulx physgunplayer"	"Ability to physgun other players"
"ulx version"	"Grants access to the ulx version command"
"gag"	"A privilege from CAMI"
"play song"	"A privilege from CAMI"
"helix - setchan"	"A privilege from CAMI"
"ulx return"	"Grants access to the ulx return command"
"plugin - dar tarjetas"	"A privilege from CAMI"
"helix - charfallover"	"A privilege from CAMI"
"helix - setfreq"	"A privilege from CAMI"
"helix - maprestart"	"A privilege from CAMI"
"ulx help"	"Grants access to the ulx help command"
"helix - rollwildlifeattack"	"A privilege from CAMI"
"sandbox settings"	"A privilege from CAMI"
"helix - itemspawnresettimer"	"A privilege from CAMI"
"helix - permitgive"	"A privilege from CAMI"
"helix - npcspawntoggle"	"A privilege from CAMI"
"helix - chareditbodygroup"	"A privilege from CAMI"
"manage private messages"	"A privilege from CAMI"
"jail"	"A privilege from CAMI"
"helix - mynotes"	"A privilege from CAMI"
"set karma"	"A privilege from CAMI"
"ulx bring"	"Grants access to the ulx bring command"
"ulx votemap2"	"Grants access to the ulx votemap2 command"
"helix - plyteleport"	"A privilege from CAMI"
"set armor"	"A privilege from CAMI"
"ulx logspawns"	"Log when players spawn objects (props, effects, etc)"
"helix - togglecharswap"	"A privilege from CAMI"
"helix - plydemote"	"A privilege from CAMI"
"ulx showmotd"	" <0/1/2/3> - MOTD mode. 0 is off."
"ulx cloak"	"Grants access to the ulx cloak command"
"freeze"	"A privilege from CAMI"
"ulx unjail"	"Grants access to the ulx unjail command"
"set rank"	"A privilege from CAMI"
"helix - itemspawnremove"	"A privilege from CAMI"
"helix - ge"	"A privilege from CAMI"
"server logs"	"A privilege from CAMI"
"ulx tsay"	"Grants access to the ulx tsay command"
"helix - plygod"	"A privilege from CAMI"
"helix - charsetbodygroup"	"A privilege from CAMI"
"noclip"	"A privilege from CAMI"
"helix - gasmask"	"A privilege from CAMI"
"helix - logs"	"A privilege from CAMI"
"helix - toggleraise"	"A privilege from CAMI"
"ulx welcomemessage"	"<msg> - This is shown to players on join."
"ulx psay"	"Grants access to the ulx psay command"
"helix - radioyell"	"A privilege from CAMI"
"respawn"	"A privilege from CAMI"
"helix - clearradiorepeaters"	"A privilege from CAMI"
"helix - plybring"	"A privilege from CAMI"
"ulx ungag"	"Grants access to the ulx ungag command"
"helix - observer"	"A privilege from CAMI"
"ulx voteban"	"Grants access to the ulx voteban command"
"ban"	"A privilege from CAMI"
"ulx banid"	"Grants access to the ulx banid command"
"ulx seeasay"	"Ability to see 'ulx asay'"
"helix - textadd"	"A privilege from CAMI"
"helix - localevent"	"A privilege from CAMI"
"edit ban"	"A privilege from CAMI"
"helix - setnickname"	"A privilege from CAMI"
"ulx adduser"	"Grants access to the ulx adduser command"
"ulx strip"	"Grants access to the ulx strip command"
"slap"	"A privilege from CAMI"
"helix - waypointadd"	"A privilege from CAMI"
"send"	"A privilege from CAMI"
"helix - doorsell"	"A privilege from CAMI"
"helix - bypass ooc timer"	"A privilege from CAMI"
"helix - plykick"	"A privilege from CAMI"
"helix - manage map scenes"	"A privilege from CAMI"
"helix - rollattribute"	"A privilege from CAMI"
"ulx logechocolors"	"Whether or not echoed commands in chat are colored"
"ulx addgroup"	"Grants access to the ulx addgroup command"
"helix - content"	"A privilege from CAMI"
"helix - getdistance"	"A privilege from CAMI"
"manage advertisements"	"A privilege from CAMI"
"ulx goto"	"Grants access to the ulx goto command"
"helix - radiobroadcast"	"A privilege from CAMI"
"helix - npcspawnadd"	"A privilege from CAMI"
"helix - forceremovebol"	"A privilege from CAMI"
"helix - manage spawn points"	"A privilege from CAMI"
"helix - charsetmodel"	"A privilege from CAMI"
"helix - waypointremove"	"A privilege from CAMI"
"helix - doorsettitle"	"A privilege from CAMI"
"helix - setvoicemail"	"A privilege from CAMI"
"helix - craftrecipe"	"A privilege from CAMI"
"ulx thetime"	"Grants access to the ulx thetime command"
"helix - plybrings"	"A privilege from CAMI"
"map restart"	"A privilege from CAMI"
"ulx rslotsvisible"	" - Sets whether slots are visible. See config for more information."
"manage reserved slots"	"A privilege from CAMI"
"ulx exec"	"Grants access to the ulx exec command"
"ulx uncloak"	"Grants access to the ulx uncloak command"
"restart round"	"A privilege from CAMI"
"ulx renamegroup"	"Grants access to the ulx renamegroup command"
"ulx jail"	"Grants access to the ulx jail command"
"ulx gimp"	"Grants access to the ulx gimp command"
"helix - permittake"	"A privilege from CAMI"
"ulx votemapsuccessratio"	""
"helix - forums"	"A privilege from CAMI"
"fspectate"	"A privilege from CAMI"
"ulx luarun"	"Grants access to the ulx luarun command"
"ulx maul"	"Grants access to the ulx maul command"
"stormfox weatheredit"	"A privilege from CAMI"
"ungag"	"A privilege from CAMI"
"see help requests"	"A privilege from CAMI"
"analytics"	"A privilege from CAMI"
"freeze props"	"A privilege from CAMI"
"helix - waypointremoveall"	"A privilege from CAMI"
"ulx votemapvetotime"	""
"helix - fr"	"A privilege from CAMI"
"helix - doorsetowner"	"A privilege from CAMI"
"ulx logechocolorplayerasgroup"	"Whether or not to use group colors for players."
"strip weapons"	"A privilege from CAMI"
"delete all reports"	"A privilege from CAMI"
"helix - manage player flags"	"A privilege from CAMI"
"ulx sslay"	"Grants access to the ulx sslay command"
"god mode"	"A privilege from CAMI"
"slay"	"A privilege from CAMI"
"set role"	"A privilege from CAMI"
"helix - droptokens"	"A privilege from CAMI"
"ulx logdir"	"The log dir under garrysmod/data"
"helix - admin context options"	"A privilege from CAMI"
"ulx motdurl"	"MOTD URL to use if ulx showMotd is 3."
"set health"	"A privilege from CAMI"
"helix - manage vendors"	"A privilege from CAMI"
"manage watchlist"	"A privilege from CAMI"
"bypass prop deletion"	"A privilege from CAMI"
"announce"	"A privilege from CAMI"
"ulx removegroup"	"Grants access to the ulx removegroup command"
"admin chat"	"A privilege from CAMI"
"ignite"	"A privilege from CAMI"
"helix - dropitem"	"A privilege from CAMI"
"slaynr"	"A privilege from CAMI"
"invisible"	"A privilege from CAMI"
"ulx ent"	"Grants access to the ulx ent command"
"ulx slay"	"Grants access to the ulx slay command"
"helix - ban character"	"A privilege from CAMI"
"ulx ungod"	"Grants access to the ulx ungod command"
"xgui_managebans"	"Allows addition, removal, and viewing of bans in XGUI."
"ulx motdfile"	"MOTD filepath from gmod root to use if ulx showMotd is 1."
"manage restrictions"	"A privilege from CAMI"
"helix - plygoto"	"A privilege from CAMI"
"ulx logechocoloreveryone"	"The color to use when everyone is targeted in echoes"
"unban"	"A privilege from CAMI"
"ulx removeuserid"	"Grants access to the ulx removeuserid command"
"ulx setgroupcantarget"	"Grants access to the ulx setgroupcantarget command"
"ulx stopvote"	"Grants access to the ulx stopvote command"
"helix - npcspawnremove"	"A privilege from CAMI"
"ulx unblind"	"Grants access to the ulx unblind command"
"helix - radiowhisper"	"A privilege from CAMI"
"helix - helix - manage player flags"	"A privilege from CAMI"
"helix - plysetarmor"	"A privilege from CAMI"
"view disconnects"	"A privilege from CAMI"
"helix - selfdesc"	"A privilege from CAMI"
"helix - plysethp"	"A privilege from CAMI"
"mute"	"A privilege from CAMI"
"ragdoll"	"A privilege from CAMI"
"ulx userallowid"	"Grants access to the ulx userallowid command"
"ulx unmute"	"Grants access to the ulx unmute command"
"remove slaynr"	"A privilege from CAMI"
"manage players"	"A privilege from CAMI"
"bypass prop blacklist"	"A privilege from CAMI"
"helix - doorbuy"	"A privilege from CAMI"
"ulx mechatenabled"	"Allow players to use '/me' in chat. 0 = Disabled, 1 = Sandbox only (Default), 2 = Enabled"
"ulx logecho"	"Echo mode 0-Off 1-Anonymous 2-Full"
"ulx rcon"	"Grants access to the ulx rcon command"
"helix - apply"	"A privilege from CAMI"
"custom vote"	"A privilege from CAMI"
"ulx groupallow"	"Grants access to the ulx groupallow command"
"ulx hiddenecho"	"Ability to see hidden echoes"
"helix - mapentremove"	"A privilege from CAMI"
"ulx csay"	"Grants access to the ulx csay command"
"ulx map"	"Grants access to the ulx map command"
"helix - chargetup"	"A privilege from CAMI"
"ulx jailtp"	"Grants access to the ulx jailtp command"
"ulx kick"	"Grants access to the ulx kick command"
"manage plugins"	"A privilege from CAMI"
"xgui_gmsettings"	"Allows changing of gamemode-specific settings on the settings tab in XGUI."
"helix - charsetname"	"A privilege from CAMI"
"helix - chanrename"	"A privilege from CAMI"
"ulx logspawnsecho"	"Echo spawns to players in server. -1 = Off, 0 = Console only, 1 = Admins only, 2 = All players. (Echoes to console)"
"ulx logechocolorself"	"The color for yourself in echoes"
"helix - rollattack"	"A privilege from CAMI"
"helix - charsetskin"	"A privilege from CAMI"
"helix - manage config"	"A privilege from CAMI"
"xgui_svsettings"	"Allows changing of server and ULX-specific settings on the settings tab in XGUI."
"ulx votebanminvotes"	""
"helix - givefullcard"	"A privilege from CAMI"
"ulx chattime"	"<time> - Players can only chat every x seconds (anti-spam). 0 to disable."
"helix - manage character whitelist"	"A privilege from CAMI"
"ulx mute"	"Grants access to the ulx mute command"
"ulx blind"	"Grants access to the ulx blind command"
"bypass prop spam"	"A privilege from CAMI"
"ulx god"	"Grants access to the ulx god command"
"ulx removeuser"	"Grants access to the ulx removeuser command"
"kick"	"A privilege from CAMI"
"ulx spawnecho"	"Ability to see spawn echoes and steamids from joined players in console"
"ulx votemapmapmode"	""
"ulx usermanagementhelp"	"Grants access to the ulx usermanagementhelp command"
"helix - rollstat"	"A privilege from CAMI"
"ulx unfreeze"	"Grants access to the ulx unfreeze command"
"ulx votebansuccessratio"	""
"ulx userallow"	"Grants access to the ulx userallow command"
"delete all private messages"	"A privilege from CAMI"
"manage prop-protection"	"A privilege from CAMI"
"ulx motd"	"Grants access to the ulx motd command"
"ulx voteecho"	""
"helix - plysetgroup"	"A privilege from CAMI"
"helix - request"	"A privilege from CAMI"
"unmute"	"A privilege from CAMI"
"no collide"	"A privilege from CAMI"
"helix - chardesc"	"A privilege from CAMI"
"ulx logfile"	"Log to file (Can still echo if off). This is a global setting, nothing will be logged to file with this off."
"ulx kickafternamechangescooldown"	"<time> - Players can change their name ulx_kickAfterXNameChanges times every x seconds."
"helix - manage character attributes"	"A privilege from CAMI"
"restrict"	"A privilege from CAMI"
"ulx logechocolorplayer"	"The color to use for players when ulx logEchoColorPlayerAsGroup is set to 0."
"helix - waypointaddnd"	"A privilege from CAMI"
"manage prop blacklist"	"A privilege from CAMI"
"helix - itemspawnforce"	"A privilege from CAMI"
"helix - reply"	"A privilege from CAMI"
"helix - respawn"	"A privilege from CAMI"
"helix - adminspawnmenu"	"A privilege from CAMI"
"ulx logechocolorconsole"	"The color that Console gets when using actions"
"helix - doorkick"	"A privilege from CAMI"
"ulx logechocolordefault"	"The default text color (RGB)"
"ulx unragdoll"	"Grants access to the ulx unragdoll command"
"helix - viewdesc"	"A privilege from CAMI"
"helix - visormessage"	"A privilege from CAMI"
"ulx votemap"	"Grants access to the ulx votemap command"
"ulx teleport"	"Grants access to the ulx teleport command"
"helix - plyfreeze"	"A privilege from CAMI"
"helix - workshop"	"A privilege from CAMI"
"return"	"A privilege from CAMI"
"helix - item menu"	"A privilege from CAMI"
"ulx rslotsmode"	" - Sets the slots mode. See config for more information."
"ulx kickafternamechanges"	"<number> - Players can only change their name x times every ulx_kickAfterNameChangesCooldown seconds. 0 to disable."
"helix - name"	"A privilege from CAMI"
"ulx groupdeny"	"Grants access to the ulx groupdeny command"
"superadmin"	"A privilege from CAMI"
"ulx logevents"	"Log events (player connect, disconnect, death)"
"go incognito"	"A privilege from CAMI"
"helix - givetokens"	"A privilege from CAMI"
"ulx whip"	"Grants access to the ulx whip command"
"stormfox settings"	"A privilege from CAMI"
"ulx votemap2minvotes"	""
"ulx unigniteall"	"Grants access to the ulx unigniteall command"
"physgun player"	"A privilege from CAMI"
"ulx reservedslots"	"Access to reserved slots"
"helix - pm"	"A privilege from CAMI"
"manage motd"	"A privilege from CAMI"
"ulx who"	"Grants access to the ulx who command"
"ulx noclip"	"Grants access to the ulx noclip command"
"helix - charsetclass"	"A privilege from CAMI"
"ulx armor"	"Grants access to the ulx armor command"
"helix - bypass prop protection"	"A privilege from CAMI"
"helix - givesecondcard"	"A privilege from CAMI"
"helix - zombie"	"A privilege from CAMI"
"ulx adduserid"	"Grants access to the ulx adduserid command"
"manage chat settings"	"A privilege from CAMI"
"ulx userdenyid"	"Grants access to the ulx userdenyid command"
"xgui_managegroups"	"Allows managing of groups, users, and access strings via the groups tab in XGUI."
"ulx logechocolormisc"	"The color for anything else in echoes"
"quick menu"	"A privilege from CAMI"
"helix - ar"	"A privilege from CAMI"
"ulx unban"	"Grants access to the ulx unban command"
"helix - roll"	"A privilege from CAMI"
"helix - manage character flags"	"A privilege from CAMI"
"helix - radiolisten"	"A privilege from CAMI"
"helix - ita"	"A privilege from CAMI"
"helix - charsearch"	"A privilege from CAMI"
"ulx veto"	"Grants access to the ulx veto command"
"helix - item spawner"	"A privilege from CAMI"
"clear decals"	"A privilege from CAMI"
"helix - chargiveitem"	"A privilege from CAMI"
"ulx logjoinleaveecho"	"Echo players leaves and joins to admins in the server (useful for banning minges)"
"ulx send"	"Grants access to the ulx send command"
"ulx seeanonymousechoes"	"Ability to see who uses a command even with ulx logEcho set to 1"
"admin"	"A privilege from CAMI"
"helix - itemspawnremoveitems"	"A privilege from CAMI"
"helix - areaedit"	"A privilege from CAMI"
"helix - manage doors"	"A privilege from CAMI"
"helix - squadmenu"	"A privilege from CAMI"
